IMAGE_NAME tilemap.png
TILE_COUNT 6
TILE01 0 0 32 32 //border
TILE02 32 0 32 32 //floor 1
TILE03 64 0 32 32 //floor 2
TILE04 0 32 32 32 //mud
TILE05 32 32 32 32 //inner walls
TILE06 64 32 32 32 //goalpost
GRID 19 35
0 0 0 0 0 0 0 0 0 0 0 0 0 0 0 0 0 0 0 0 0 0 0 0 0 0 0 0 0 0 0 0 0 0 0
0 1 1 1 1 1 1 1 1 0 1 1 1 1 1 1 1 0 1 1 1 1 1 1 1 2 1 1 0 1 1 1 5 1 0
0 1 1 2 1 1 1 1 1 0 1 1 1 1 1 1 1 0 1 1 2 3 3 1 1 1 1 1 0 1 1 1 2 1 0
0 1 1 1 1 1 1 1 1 0 1 1 1 3 3 1 1 0 1 1 1 3 3 2 1 2 1 1 0 1 1 1 2 1 0
0 1 1 1 1 1 0 0 0 0 1 1 1 3 3 1 1 0 1 1 1 2 1 1 1 1 1 1 1 1 1 1 1 1 0
0 1 1 1 1 1 1 1 1 1 1 1 1 1 1 1 1 0 1 1 1 1 1 1 1 1 3 1 1 2 1 1 1 1 0
0 1 1 2 1 1 1 1 1 1 1 1 1 1 2 1 1 0 0 0 0 1 1 1 1 1 1 1 1 1 1 1 1 1 0
0 1 1 1 1 1 1 1 1 1 1 1 1 1 1 1 1 0 1 1 1 1 1 1 1 1 1 1 1 1 1 1 1 1 0
0 0 0 0 1 1 1 1 1 3 3 1 1 1 1 1 1 0 1 1 1 1 1 1 1 1 1 1 1 1 1 1 1 1 0
0 1 1 1 1 1 1 1 1 3 3 1 4 4 1 1 1 1 1 1 1 2 1 1 1 4 4 4 2 1 1 2 0 1 0
0 1 1 1 1 1 1 1 1 1 1 1 4 4 1 1 1 1 1 1 1 1 1 1 1 4 4 4 4 1 1 1 0 0 0
0 1 1 1 1 1 3 1 1 1 1 1 2 1 1 1 1 1 1 2 2 1 1 1 1 2 4 4 4 1 1 1 1 1 0
0 1 3 1 1 1 3 1 1 1 1 1 1 1 2 1 1 1 3 3 2 1 1 1 1 1 1 1 1 1 1 1 1 1 0
0 1 1 1 2 1 1 1 1 1 1 1 1 1 1 1 1 1 1 1 1 1 1 1 1 1 1 1 1 1 1 1 1 1 0
0 1 1 1 1 1 1 1 1 1 1 1 2 1 1 1 1 1 1 1 1 1 1 1 1 1 2 1 1 1 1 1 1 1 0
0 1 1 1 1 1 1 1 1 1 0 1 1 1 1 4 4 4 1 1 1 1 1 1 1 1 1 1 0 1 1 0 1 1 0
0 1 1 1 0 1 1 2 1 1 0 0 1 1 1 4 4 4 1 1 1 1 1 0 1 1 1 1 0 1 0 0 1 1 0
0 2 2 2 0 1 1 1 1 1 1 0 1 1 1 1 1 1 1 1 1 1 0 0 1 1 1 1 0 1 1 0 1 1 0
0 0 0 0 0 0 0 0 0 0 0 0 0 0 0 0 0 0 0 0 0 0 0 0 0 0 0 0 0 0 0 0 0 0 0
PLAYER_START_POS 150 115
ENEMY_COUNT 3
ENEMY01_START_POS 150 600
ENEMY02_START_POS 1100 550
ENEMY03_START_POS 650 150
