IMAGE_NAME tilemap.png
TILE_COUNT 21
TILE01 0 64 32 32 //corner ul
TILE02 32 64 32 32 //upper wall
TILE03 64 64 32 32 //corner ur
TILE04 0 96 32 32 //wall l
TILE05 32 96 32 32 // floor 
TILE06 64 96 32 32 //wall r
TILE07 0 128 32 32 //corner ll
TILE08 32 128 32 32 //lower wall
TILE09 64 128 32 32 //corner lr
TILE10 0 160 32 32 //mid-wall vert-top
TILE11 32 160 32 32 //mid-wall vert-mid
TILE12 64 160 32 32 //mid-wall vert-bot
TILE13 0 192 32 32 //mid-wall hor-l
TILE14 32 192 32 32 //mid-wall hor-mid
TILE15 64 192 32 32 /mid-wall hor-r
TILE16 0 224 32 32 //vert table 1
TILE17 32 224 32 32 //vert table 2
TILE18 64 224 32 32 //vert table 3
TILE19 0 256 32 32 //hor table 1
TILE20 32 256 32 32 //hor table 2
TILE21 64 256 32 32 //hor table 3
GRID 20 35
0 1 1 1 1 1 1 1 1 1 1 1 1 1 1 1 1 1 1 1 1 1 1 1 1 1 1 1 1 1 1 1 1 1 2
3 4 4 4 4 4 4 4 4 4 4 4 4 4 4 4 4 4 4 4 4 4 4 4 4 4 4 4 4 4 4 4 4 4 5
3 4 4 4 4 4 4 4 4 4 4 4 4 4 4 4 4 4 4 4 4 4 4 4 4 4 4 4 4 4 4 4 4 4 5
3 4 4 4 4 4 4 4 4 4 4 4 4 4 4 4 4 4 4 4 4 4 4 4 4 4 4 4 4 4 4 4 4 4 5
3 4 4 4 4 4 4 4 4 4 4 4 4 4 4 4 4 4 4 4 4 4 4 4 4 4 4 4 4 4 4 4 4 4 5
3 4 4 4 4 4 4 4 4 4 4 4 4 4 4 4 4 4 4 4 4 4 4 4 4 4 4 4 4 4 4 4 4 4 5
3 4 4 4 4 4 4 4 4 4 4 4 4 4 4 4 4 4 4 4 4 4 4 4 4 4 4 4 4 4 4 4 4 4 5
3 4 4 4 4 4 4 4 4 4 4 4 4 4 4 4 4 4 4 4 4 4 4 4 4 4 4 4 4 4 4 4 4 4 5
3 4 4 4 4 4 4 4 4 4 4 4 4 4 4 4 4 4 4 4 4 4 4 4 4 4 4 4 4 4 4 4 4 4 5
6 7 7 7 7 7 7 7 7 7 7 7 2 4 4 4 0 7 7 7 7 7 7 7 7 7 2 4 4 4 0 7 7 7 8
4 4 4 4 4 4 4 4 4 4 4 4 5 4 4 4 3 4 4 4 4 4 4 4 4 4 5 4 4 4 3 4 4 4 4
0 1 1 1 1 1 1 1 1 1 1 1 8 4 4 4 6 1 1 1 1 1 1 1 1 1 8 4 4 4 6 1 1 1 2
3 4 4 4 4 4 4 4 4 4 4 4 4 4 4 4 4 4 4 4 4 4 4 4 4 4 4 4 4 4 4 4 4 4 5
3 4 4 4 4 4 4 4 4 4 4 4 4 4 4 4 4 4 4 4 4 4 4 4 4 4 4 4 4 4 4 4 4 4 5
3 4 4 4 4 4 4 4 4 4 4 4 4 4 4 4 4 4 4 4 4 4 4 4 4 4 4 4 4 4 4 4 4 4 5
3 4 4 4 4 4 4 4 4 4 4 4 4 4 4 4 4 4 4 4 4 4 4 4 4 4 4 4 4 4 4 4 4 4 5
3 4 4 4 4 4 4 4 4 4 4 4 4 4 4 4 4 4 4 4 4 4 4 4 4 4 4 4 4 4 4 4 4 4 5
3 4 4 4 4 4 4 4 4 4 4 4 4 4 4 4 4 4 4 4 4 4 4 4 4 4 4 4 4 4 4 4 4 4 5
3 4 4 4 4 4 4 4 4 4 4 4 4 4 4 4 4 4 4 4 4 4 4 4 4 4 4 4 4 4 4 4 4 4 5
6 7 7 7 7 7 7 7 7 7 7 7 7 7 7 7 7 7 7 7 7 7 7 7 7 7 7 7 7 7 7 7 7 7 8
PLAYER_START_POS 100 115 // lower left of the map
ENEMY_COUNT 3
ENEMY01_START_POS 150 600
ENEMY02_START_POS 1100 550
ENEMY03_START_POS 650 150
ENEMY04_START_POS 800 650
ENEMY05_START_POS 300 225
ENEMY06_START_POS 1200 700
